10x20
********************
*  R        R      *
*   R *  *  *      *
*        H  *      *
*   **     *   *   *
*   *      *  *    *
*     * *    R  *  *
*  *           **  *
*     R      *     *
*********************
